*******************
*.................*
*O*.**.*****.**.*O*
*.*.**.*...*.**.*.*
*.*....*.*.*....*.*
*.**.*.*.*.*.*.**.*
*....*...*...*....*
**.*******.*****.**
**...*.......*...**
...*.*.**-**.*.*...
****...*%#&*...****
...*.*.*****.*.*...
**...*.......*...**
**.*.***.*.***.*.**
**.*.....*....$*.**
**.***.*.*.*.***.**
*......*.@.*......*
*.**.*.*****.*.**.*
*.*..*.......*..*.*
*.*.****...****.*.*
*........*....$...*
*******************
