*******************
*.................*
*.................*
*O...............O*
*.................*
*.................*
*.................*
*.................*
**.......$.......**
........* *........
*......*%#&*......*
.......*****.......
*.................*
*.................*
*.................*
*.................*
*........@........*
*.................*
*O...............O*
*.................*
*.................*
*******************