*******************
*.................*
*O*.**.*****.**.*O*
*.*.**.*...*.**.*.*
*.*....*.*.*....*.*
*.**.*.*.*.*.*.**.*
*....*...*...*....*
**.*******.*****.**
**...*...$...*...**
...*.*.**-**.*.*...
****...*%#&*...****
...*.*.*****.*.*...
**...*.......*...**
**.*.***.*****.*.**
**.*.....*.....*.**
**.***.*.*.*.***.**
*......*.@.*......*
*.*..*.*****.*.**.*
*O*.*........* .*.*
*.*.****...****.*.*
*........*........*
*******************
