*******************
*.................*
*.*.**.*****.**.*.*
*O*.**.*...*.**.*O*
*.*....*.*.*....*.*
*.**.*.*.*.*.*.**.*
*....*...*...*....*
**.*****.*.*****.**
**...*...$...*...**
...*.*.**-**.*.*...
****...*%#&*...****
...*.*.*****.*.*...
**...*.......*...**
**.*.***.*.***.*.**
**.*.....*.....*.**
**.***.*.*.*.***.**
*......*.@.*......*
*.**.*.*****.*.**.*
*O*..*.......*..*O*
*.*.****...****.*.*
*........*........*
*******************
